2,1,1,1,1,1,1,1,1,1,1,1,1,1,1,1
2,1,1,1,1,1,1,1,1,1,1,1,3,1,4,1
2,2,2,1,1,1,1,1,1,1,1,1,1,1,1,1
1,1,2,1,1,1,1,1,3,4,1,1,5,1,6,1
1,1,2,1,1,1,1,1,5,6,1,1,1,1,1,1
1,1,2,1,1,1,1,1,1,1,1,1,1,1,1,1
1,1,2,1,1,1,1,1,1,1,1,1,1,3,4,1
1,1,2,1,1,1,1,1,1,1,1,1,1,5,6,1
1,1,2,2,2,2,2,2,2,2,1,1,1,1,1,1
1,1,1,1,1,1,1,1,1,2,2,2,2,2,2,2
1,1,1,1,1,1,1,1,1,2,1,1,1,1,1,1
1,1,1,1,1,1,1,1,1,2,1,1,1,1,1,1
1,1,1,3,4,1,1,1,1,2,1,1,1,3,4,1
1,1,1,5,6,1,1,1,1,2,1,1,1,5,6,1
1,1,1,1,1,1,1,1,1,2,2,2,1,1,1,1
1,1,1,1,1,1,1,1,1,1,1,2,1,1,1,1